NO t/wall.xpm
EA t/wall.xpm
WE t/wall.xpm
SO t/wall.xpm

C 50,50,50
F 75,75,75

11111111111111111111
10000000000000000001
10E00001010000000001
10000001010000000001
10000000000000000001
10000000000000000001
10000000000000000001
10000000000000000001
10000000000000000001
10000000000000000001
11111111111111111111